absent - présent
abondant - insuffisant
accepter - refuser
correct - erroné
accuser - défendre
admettre - nier
avancer - reculer
á pied - á cheval
après - avant
agile - maladroit
agonie - extase
étranger - native
tous - aucun
seul - ensemble
toujours - jamais
approximatif - exact
amuser - ennuyer
ange - diable
colère - gentillesse
antique - moderne
à part - ensemble
applaudir - huer
approuver - rejeter
arrogant - poli
monter - descendre
honteux - fier
endormi - réveillé
consentir - refuser
attaquer - défendre
authentique - imitation
terrible - merveilleux
contre - pour