gai : gaieté
blanc : blancheur, blanchissage
bon : bonté
bref : brièveté
chaud : chaleur
lâche : lâcheté
cruel : cruauté
faible : faiblesse
mince : minceur
maigre : maigreur
adroit : adresse
doux : douceur
dur : dureté
ivre : ivresse
ardent : ardeur
épais : épaisseur
svelte : sveltesse
fin : finesse
ferme : fermeté
souple : souplesse
franc : franchise
gourmand : gourmandise
naïf : naïveté
loyal : loyauté
propre : propreté
rouge : rougeur
méchant : méchanceté
fier : fierté
pâle : pâleur
pauvre : pauvreté
rude : rudesse
sage : sagesse
bête : bêtise
maladroit : maladresse
sec : sècheresse
sot : sottise
tendre : tendresse
