abaisser : abaissement
abandonner : abandon
abattre : abattage, abattement
abolir : abolition
abonder : abondance
aboyer : aboiement
abriter : abri
accélérer : accélération
accoucher : accouchement
accroître : accroissement
accueillir : accueil
accumuler : accumulation
accuser : accusation
acharner : acharnement
acheter : achat
achever : achèvement
acquérir : acquisition
acquitter : acquittement
actualiser : actualisation
adapter : adaptation
adopter : adoption
additionner : addition
adhérer : adhésion
admettre : admission
administrer : administration
admirer : admiration
adorer : adoration
aérer : aération
affirmer : affirmation
afficher : affichage
agrandir : agrandissement
aider : aide
aimer : amour
ajourner : ajournement
alerter : alerte
améliorer : amélioration
atterrir : atterrissage
amputer : amputation
amuser : amusement
analyser : analyse
anéantir : anéantissement
annexer : annexion
annoncer : annonce
annuler : annulation
apparaître : apparition
appeler : appel, appellation
applaudir : applaudissement
approcher : approche
approfondir : approfondissement
approuver : approbation
arrêter : arrêt, arrestation
arriver : arrivée, arrivage
assassiner : assassinat
attaquer : attaque
attendre : attente
augmenter : augmentation
autoriser : autorisation
avorter : avortement
avouer : aveu
bagarrer : bagarre
baigner : bain
bégayer : bégaiement
bénir : bénédiction
bavarder : bavardage
blêmir : blêmissement
bronzer : bronzage
cambrioler : cambriolage
capituler : capitulation
capturer : capture
célébrer : célébration
censurer : censure
chanter : chant, chantage
charger : chargement
choisir : choix
circuler : circulation
collaborer : collaboration
commencer : commencement
comparer : comparaison
conclure : conclusion
condamner : condamnation
confisquer : confiscation
conquérir : conquête
consoler : consolation
consommer : consommation
construire : construction
contempler : contemplation
contester : contestation
contraindre : contrainte
contrôler : contrôle
convoquer : convocation
corrompre : corruption
corriger : correction
créer : création
cueillir : cueillette
déclarer : déclaration
démolir : démolition
dépeindre : description
déranger : dérangement
déraper : dérapage
détruire : destruction
dévaster : dévastation
développer : développement
diminuer : diminution
diriger : direction
discuter : discussion
disparaître : disparition
distinguer : distinction
distraire : distraction
distribuer : distribution
divertir : divertissement
éclairer : éclairage
effondrer : effondrement
élargir : élargissement
éliminer : élimination
élire : élection
émanciper : émancipation
employer : emploi
enfreindre : infraction
enfuir : fuite
entrer : entrée
envahir : invasion, envahissement
envoyer : envoi
épouser : mariage
éteindre : extinction 
étreindre : étreinte
évacuer : évacuation
évader : évasion
évanouir : évanouissement
exagérer : exagération
examiner : examen
expliquer : explication
exploiter : exploitation
exporter : exportation
expulser : expulsion
fabriquer : fabrication
fermer : fermeture
fondre : fonte
fouiller : fouille
fuir : fuite
gagner : gain
guérir : guérison
haïr : haine
hésiter : hésitation
imiter : imitation
immigrer : immigration
inaugurer : inauguration
indemniser : indemnisation
indigner : indignation
indiquer : indication
initier : initiation
injecter : injection
inonder : inondation
installer : installation 
instruire : instruction
interdire : interdiction
interrompre : interruption
intervenir : intervention
intimider : intimidation
introduire : introduction
inviter : invitation
lécher : léchage
libérer : libération
licencier : licenciement
lire : lecture
lister : liste
livrer : livraison
maigrir : amaigrissement
maintenir : maintien
manifester : manifestation
manipuler : manipulation
marier : mariage
maudire : malédiction
médire : médisance
mécontenter : mécontentement
méfier : méfiance
mentir : mensonge
mépriser : mépris
méprendre : méprise
modifier : modification
mordre : morsure
mourir : mort
naître : naissance
ouvrir : ouverture
partir : départ
perdre : perte
pleuvoir : pluie
polluer : pollution
poursuivre : poursuite
prédire : prédiction
préparer : préparation
prêter : prêt
produire : production
prolonger : prolongation
prouver : preuve
protéger : protection
publier : publication
regretter : regret
répéter : répétition
reprendre : reprise
revenir : retour
réussir : réussite
rompre : rupture
satisfaire : satisfaction
sauver : sauvetage
sortir : sortie
supprimer : suppression
tomber : tombée
transformer : transformation
tuer : tuerie
utiliser : utilisation
vacciner : vaccination
venir : venue
visiter : visite
voler : vol
